A,L,1,D
A,G,5,D
A,E,1,A
A,E,2,A
A,E,3,A
A,E,4,A
A,E,5,A
D,E,3,A
#
20
10 20
....................
..**..**............
....................
....*......***......
...***.....***......
....*......**.......
....................
............****....
.**...**.......*....
....................